AFGHANISTAN - (AF)
ALBANIA - (AL)
ALGERIA - (AG)
ANDORRA - (AN)
ANGOLA - (AO)
ANGUILLA - (AV)
ANTIGUA AND BARBUDA - (AC)
ARGENTINA - (AR)
ARMENIA - (AM)
ARUBA - (AA)
ASHMORE AND CARTIER ISLANDS - (AT)
AUSTRALIA - (AS)
AUSTRIA - (AU)
AZERBAIJAN - (AJ)
BAHAMAS, THE - (BF)
BAHRAIN - (BA)
BANGLADESH - (BG)
BARBADOS - (BB)
BASSAS DA INDIA - (BS)
BELARUS - (BO)
BELGIUM - (BE)
BELIZE - (BH)
BENIN - (BN)
BERMUDA - (BD)
BHUTAN - (BT)
BOLIVIA - (BL)
BOSNIA AND HERZEGOVINA - (BK)
BOTSWANA - (BC)
BOUVET ISLAND - (BV)
BRAZIL - (BR)
BRITISH INDIAN OCEAN TERRITORY - (IO)
BRITISH VIRGIN ISLANDS - (VI)
BRUNEI - (BX)
BULGARIA - (BU)
BURKINA FASO - (UV)
BURMA - (BM)
BURUNDI - (BY)
CAMBODIA - (CB)
CAMEROON - (CM)
CANADA - (CA)
CAPE VERDE - (CV)
CAYMAN ISLANDS - (CJ)
CENTRAL AFRICAN REPUBLIC - (CT)
CHAD - (CD)
CHILE - (CI)
CHINA - (CH)
CHRISTMAS ISLAND - (KT)
CLIPPERTON ISLAND - (IP)
COCOS (KEELING) ISLANDS - (CK)
COLOMBIA - (CO)
COMOROS - (CN)
CONGO - (CF)
CONGO, DEMOCRATIC REPUBLIC OF THE - (CG)
COOK ISLANDS - (CW)
CORAL SEA ISLANDS - (CR)
COSTA RICA - (CS)
CÔTE D'IVOIRE - (IV)
CROATIA - (HR)
CUBA - (CU)
CYPRUS - (CY)
CZECH REPUBLIC - (EZ)
DENMARK - (DA)
DJIBOUTI - (DJ)
DOMINICA - (DO)
DOMINICAN REPUBLIC - (DR)
EAST TIMOR - (TT)
ECUADOR - (EC)
EGYPT - (EG)
EL SALVADOR - (ES)
EQUATORIAL GUINEA - (EK)
ERITREA - (ER)
ESTONIA - (EN)
ETHIOPIA - (ET)
EUROPA ISLAND - (EU)
FALKLAND ISLANDS (ISLAS MALVINAS) - (FK)
FAROE ISLANDS - (FO)
FIJI - (FJ)
FINLAND - (FI)
FRANCE - (FR)
FRENCH GUIANA - (FG)
FRENCH POLYNESIA - (FP)
FRENCH SOUTHERN AND ANTARCTIC LANDS - (FS)
GABON - (GB)
GAMBIA, THE - (GA)
GAZA STRIP - (GZ)
GEORGIA - (GG)
GERMANY - (GM)
GHANA - (GH)
GIBRALTAR - (GI)
GLORIOSO ISLANDS - (GO)
GREECE - (GR)
GREENLAND - (GL)
GRENADA - (GJ)
GUADELOUPE - (GP)
GUATEMALA - (GT)
GUERNSEY - (GK)
GUINEA - (GV)
GUINEA-BISSAU - (PU)
GUYANA - (GY)
HAITI - (HA)
HEARD ISLAND AND MCDONALD ISLANDS - (HM)
HONDURAS - (HO)
HONG KONG - (HK)
HUNGARY - (HU)
ICELAND - (IC)
INDIA - (IN)
INDONESIA - (ID)
IRAN - (IR)
IRAQ - (IZ)
IRELAND - (EI)
ISLE OF MAN - (IM)
ISRAEL - (IS)
ITALY - (IT)
JAMAICA - (JM)
JAN MAYEN - (JN)
JAPAN - (JA)
JERSEY - (JE)
JORDAN - (JO)
JUAN DE NOVA ISLAND - (JU)
KAZAKHSTAN - (KZ)
KENYA - (KE)
KIRIBATI - (KR)
KUWAIT - (KU)
KYRGYZSTAN - (KG)
LAOS - (LA)
LATVIA - (LG)
LEBANON - (LE)
LESOTHO - (LT)
LIBERIA - (LI)
LIBYA - (LY)
LIECHTENSTEIN - (LS)
LITHUANIA - (LH)
LUXEMBOURG - (LU)
MACAU - (MC)
MACEDONIA, THE FORMER YUGOSLAV REPUBLIC OF - (MK)
MADAGASCAR - (MA)
MALAWI - (MI)
MALAYSIA - (MY)
MALDIVES - (MV)
MALI - (ML)
MALTA - (MT)
MARSHALL ISLANDS - (RM)
MARTINIQUE - (MB)
MAURITANIA - (MR)
MAURITIUS - (MP)
MAYOTTE - (MF)
MEXICO - (MX)
MICRONESIA, FEDERATED STATES OF - (FM)
MOLDOVA - (MD)
MONACO - (MN)
MONGOLIA - (MG)
MONTSERRAT - (MH)
MOROCCO - (MO)
MOZAMBIQUE - (MZ)
NAMIBIA - (WA)
NAURU - (NR)
NEPAL - (NP)
NETHERLANDS - (NL)
NETHERLANDS ANTILLES - (NT)
NEW CALEDONIA - (NC)
NEW ZEALAND - (NZ)
NICARAGUA - (NU)
NIGER - (NG)
NIGERIA - (NI)
NIUE - (NE)
NO MAN'S LAND - (NM)
NORFOLK ISLAND - (NF)
NORTH KOREA - (KN)
NORWAY - (NO)
OCEANS - (OS)
OMAN - (MU)
PAKISTAN - (PK)
PALAU - (PS)
PANAMA - (PM)
PAPUA NEW GUINEA - (PP)
PARACEL ISLANDS - (PF)
PARAGUAY - (PA)
PERU - (PE)
PHILIPPINES - (RP)
PITCAIRN ISLANDS - (PC)
POLAND - (PL)
PORTUGAL - (PO)
QATAR - (QA)
REUNION - (RE)
ROMANIA - (RO)
RUSSIA - (RS)
RWANDA - (RW)
SAINT HELENA - (SH)
SAINT KITTS AND NEVIS - (SC)
SAINT LUCIA - (ST)
SAINT PIERRE AND MIQUELON - (SB)
SAINT VINCENT AND THE GRENADINES - (VC)
SAMOA - (WS)
SAN MARINO - (SM)
SAO TOME AND PRINCIPE - (TP)
SAUDI ARABIA - (SA)
SENEGAL - (SG)
SERBIA AND MONTENEGRO - (YI)
SEYCHELLES - (SE)
SIERRA LEONE - (SL)
SINGAPORE - (SN)
SLOVAKIA - (LO)
SLOVENIA - (SI)
SOLOMON ISLANDS - (BP)
SOMALIA - (SO)
SOUTH AFRICA - (SF)
SOUTH GEORGIA AND THE SOUTH SANDWICH ISLANDS - (SX)
SOUTH KOREA - (KS)
SPAIN - (SP)
SPRATLY ISLANDS - (PG)
SRI LANKA - (CE)
SUDAN - (SU)
SURINAME - (NS)
SVALBARD - (SV)
SWAZILAND - (WZ)
SWEDEN - (SW)
SWITZERLAND - (SZ)
SYRIA - (SY)
TAIWAN - (TW)
TAJIKISTAN - (TI)
TANZANIA - (TZ)
THAILAND - (TH)
TOGO - (TO)
TOKELAU - (TL)
TONGA - (TN)
TRINIDAD AND TOBAGO - (TD)
TROMELIN ISLAND - (TE)
TUNISIA - (TS)
TURKEY - (TU)
TURKMENISTAN - (TX)
TURKS AND CAICOS ISLANDS - (TK)
TUVALU - (TV)
UGANDA - (UG)
UKRAINE - (UP)
UNDERSEA FEATURES - (UF)
UNITED ARAB EMIRATES - (AE)
UNITED KINGDOM - (UK)
UNITED STATES - (US)
URUGUAY - (UY)
UZBEKISTAN - (UZ)
VANUATU - (NH)
VATICAN CITY - (VT)
VENEZUELA - (VE)
VIETNAM - (VM)
VIRGIN ISLANDS - (VQ)
WALLIS AND FUTUNA - (WF)
WEST BANK - (WE)
WESTERN SAHARA - (WI)
YEMEN - (YM)
ZAMBIA - (ZA)
ZIMBABWE - (ZI)